___#___##
_#___#___
_#####_#_
__##___#_
#_#__#_#_
____##___
_##_##_#_
_____#___
####___##