__###############__
#_________________#
#_#######_#_#####_#
#_#_______#_#___#_#
#_#########_###_#_#
#_______________#_#
#_###############_#
#_________________#
#_######_########_#
#_______________#_#
#_####_########_#_#
#_______________#_#
#_##_##########_#_#
#_#___________#_#_#
#_#_###########_#_#
#_#_____________#_#
#_##_############_#
#_________________#
__###############__