_#_#___##
_#___#___
_#####_##
__##___#_
#_#__#_#_
__#_##_#_
_##_##_#_
_____#___
####_#_##