_####____#___##_
______##_#_#____
_####__#___##__#
___###__###__#_#
_#_##___###__#_#
_#__#_#__#__##__
_##___#____####_
___#___#_#__##__
_#_#_#__x______#
##_#___#_#_###__
#___#_##______#_
__####___##_#_#_
#__##__#____#___
__#___##_#####_#
_###_##__#___#_#
_____#_____#____